21
21
111111111111111111111
111111100000001111111
111111101111101111111
111111100000001111111
111111111101111111111
111110000000000011111
111110011101110011111
100010101101101010001
101010110101011010101
101010111000111010101
101000000000000000101
101010111000111010101
101010110101011010101
100010101101101010001
111110011101110011111
111110000000000011111
111111111101111111111
111111100000001111111
111111101111101111111
111111100000001111111
111111111111111111111
