35
47
00000000000000000000000000000000000000000000000
11111110000000000000000000000000000000000000000
10000010000000000000000000000000000000000000000
10000010000000000000000000000000000000000000000
10000010000000000000000000000000000000000000000
10101111111111111111111111111111111111100000000
10101000001010000000000000000000100010100000000
10101011101011110001111111111000101011100000000
10101000101000000000000000000000101000100000000
10101110101111111111111111111100101011111110000
10101000100000000000000000000000101010000010000
10101011111111111111111111111011101010111010000
10101000100000000000000000001010001010101010000
10101110101111111111111111101011111010101010000
10101000101000000000000000101010000010101010000
10101111101011111111111110101010011110101010000
10100010101010000000000010101010010000101010000
10100110101010111111111010101011010000101010000
10111110101010100000001010101010010000101010000
10001010001010101111101010101010110000101010000
10101010001010101000101010101010010000101010000
10101010001010101010101010101011011110101010000
10100010001010101010001010101010010010100010000
10111111101010101011111010101010000010101110000
10000010001010101000000010101011111110100010000
11110010001010101111111110101000000000111010000
10000010111010100000000000101011111111100010000
10111110001010111111111111101010000000101110000
10000010001010000000000000001010111100100010000
10000011101011111111111111111010100100111010000
11110010001000000000000000000010100100100010000
10000010001111111111111111111110100000101110000
10111110111000000100000001000010111111100010000
10000000000000100000010000001000000000100010000
11111111111111111111111111111111111111111010000
