5
5
00000
00000
00100
00011
00000
8
8
00000000
00000000
00100001
00100111
00100010
00100000
00111111
00000000

